1111111111
1000000001
1011111101
1010000101
1010110101
1010100101
1010101101
1010101001
1010101011
1111111111
