11111111111111111111111111
10000000000000000000000001
10111101111011011110111101
10111101111011011110111101
10111101111011011110111101
10000000000000000000000001
10111101011111111010111101
10101101000000000000000001
11111101111011011110111111
11111101000000000010111111
11111101011100111010111111
10000100000000000000000001
11111101011111111010111111
11111101000000000010111111
11111101011111111010111111
10110000000000000000000001
10111101111011011110000001
100000000000000000000000P1
11111111111111111111111111
