111111111111111111111
1111110000000011110P1
100000100000111000011
100111100100000110011
100000111111110000111
111111111111111111111
