1111111
1001001
1001001
1000001
100P001
1001001
1111111